XX      XX
   XXXX   
          
  XXTTXX  
X X    X X
X X    X X
  XXTTXX  
          
   XXXX   
XX      XX